********************************
*                              *
*                              *
*                              *
*                              *
*                              *
*      AA                      *
*                              *
*       A                      *
*                              *
*       A                      *
*                              *
*       A                      *
*                              *
*                              *
*                              *
*                              *
*                              *
*                              *
*                              *
*                              *
*                              *
*                              *
********************************
